NO ./assets/texture/NO.xpm
SO ./assets/texture/SO.xpm
WE ./assets/texture/WE.xpm
EA ./assets/texture/EA.xpm
F 220,100,0
C 225,30,0

        1111111111111111111111111
        1000000000110000000000001
        1011000001110000000000001
        1001000000000000000000001
111111111111111111111111111111111
                                 
        1111111111111111111111111
        1000000000110000000000001
        1011000001110000000000001
        100100000000000000N000001
111111111111111111111111111111111