NO ./assets/texture/NO.xpm
SO ./assets/texture/SO.xpm
WE ./assets/texture/WE.xpm
EA ./assets/texture/EA.xpm

F ./assets/texture/BOT.xpm
C ./assets/texture/TOP.xpm

111111111111111111111111111111111
100000001E00000000110000002000001
100000001011000001110000000200001
100000001011000000000000002000001
111111111911000001110000000200001
100000000011000001110111111111111
111101111111110111000000100010001
111101111111110111010100100010001
110000001101010111000000100010001
100000000000000011000000100010001
100000000000000011010100100010001
110000011101010111110111100011101
11110111 1110101 1011110100010001
11111111 1111111 1111111111111111