NO ./assets/texture/NO.xpm
SO ./assets/texture/SO.xpm
WE ./assets/texture/WE.xpm
EA ./assets/texture/EA.xpm
F 220,100,0
C 225,30,0


1111111
1N10001
1000001
1000001
1000001
1000001
1000001
1000001
1000001
1111111
